00000001000000010001100000110000100010000011000001
00000100011000000000011101100010100001000101011001
00000000000010011000101001001000011000110000000000
00000110010000000000100000000110100000100000000010
00000010000100000000101000000010000110001000000000
00100000000001100010001010000000000100001000000000
00000100000000101000000000010010001000000000000100
10011001100000000100110000001000000000000000010001
00000000111000000000101000011000000000000100000000
01000000000110000000010101000000011011000000010000
